[info]
background: Images/background.png
map: ....##..##...........................................
     ....######...........................................
     .........---..---....................................
     ---...........---....................................
     ------.--....--##....................................
     ---.--..--....-##....................................
     ------....-----##....................................
     ---.....--....-##....................................
     ------.......--##....................................
     ----------....-##....................................
     ------.......--#########.............................

[.]
type: grass
tf = 0
tc = 17
collide = 0

[#]
type = wall
tf = 6
tc = 8
collide = 1

[-]
type = water
tf = 0
tc = 14
collide = 1
